10 10
######  ##
  #  ## ##
# ### ## #
#   ##   #
### ## # #
###    # #
# ## ### #
##  ## # #
### # ##
# ### # ##














































































